automation.hc_auto_broadcast_basement_setpoint	on		HC Auto Broadcast Basement Setpoint
automation.hc_auto_broadcast_first_floor_setpoint	on		HC Auto Broadcast First Floor Setpoint
automation.hc_auto_broadcast_garage_setpoint	on		HC Auto Broadcast Garage Setpoint
automation.hc_auto_broadcast_master_setpoint_overrides_floors	on		HC Auto Broadcast Master Setpoint (Overrides Floors)
automation.hc_auto_broadcast_upper_floor_setpoint	on		HC Auto Broadcast Upper Floor Setpoint
automation.hc_dispatcher_advisory_reset_counters_daily	on		HC Dispatcher Advisory - Reset Counters Daily
automation.hc_dispatcher_advisory_track_call_starts	on		HC Dispatcher Advisory - Track Call Starts
binary_sensor.boiler_room_water_sensor_water	off		Boiler Room Water Sensor Water
binary_sensor.hc_any_call_for_heat	on		HC Any Call For Heat
binary_sensor.hc_basement_call_for_heat	on		HC Basement Call For Heat
binary_sensor.hc_boiler_firing_proxy	on		HC Boiler Firing Proxy
binary_sensor.hc_circulator_running_proxy	on		HC Circulator Running Proxy
binary_sensor.hc_dispatch_short_cycle_risk	off		HC Dispatch Short Cycle Risk
binary_sensor.hc_first_floor_call_for_heat	on		HC First Floor Call For Heat
binary_sensor.hc_garage_call_for_heat	off		HC Garage Call For Heat
binary_sensor.hc_upper_floor_call_for_heat	off		HC Upper Floor Call For Heat
binary_sensor.hc_whole_house_call_for_heat	on		HC Whole House Call For Heat
binary_sensor.hc_z1_call_for_heat	on		HC Z1 – First Floor Bedroom & Bath – Call For Heat
binary_sensor.hc_z1_heat_allowed	off		HC Z1 Heat Allowed
binary_sensor.hc_z2_call_for_heat	off		HC Z2 – Office & Upper Guest – Call For Heat
binary_sensor.hc_z2_heat_allowed	off		HC Z2 Heat Allowed
binary_sensor.hc_z3_call_for_heat	off		HC Z3 – Basement Bath & Common – Call For Heat
binary_sensor.hc_z3_heat_allowed	off		HC Z3 Heat Allowed
binary_sensor.hc_z4_call_for_heat	off		HC Z4 – Garage – Call For Heat
binary_sensor.hc_z4_heat_allowed	off		HC Z4 Heat Allowed
binary_sensor.hc_z5_call_for_heat	off		HC Z5 – First Floor Living – Call For Heat
binary_sensor.hc_z5_heat_allowed	off		HC Z5 Heat Allowed
binary_sensor.hc_z6_call_for_heat	off		HC Z6 – Master – Call For Heat
binary_sensor.hc_z6_heat_allowed	off		HC Z6 Heat Allowed
binary_sensor.hc_z7_call_for_heat	off		HC Z7 – Basement Bar & TV South – Call For Heat
binary_sensor.hc_z7_heat_allowed	off		HC Z7 Heat Allowed
binary_sensor.hc_z8_call_for_heat	on		HC Z8 – Dining Room – Call For Heat
binary_sensor.hc_z8_heat_allowed	off		HC Z8 Heat Allowed
binary_sensor.hc_z9_call_for_heat	on		HC Z9 – Basement Bedroom – Call For Heat
binary_sensor.hc_z9_heat_allowed	on		HC Z9 Heat Allowed
climate.giovani_s_device	off		master
climate.giovani_s_device_2	off		office
climate.upper_guest	off		upper guest
climate.upper_hall	off		upper hall
climate.z1_first_floor_bedroom_and_bath	heat		z1 first floor bedroom and bath
climate.zone_2_second_floor_office_and_upper_guest	heat		zone 2 second floor office and upper guest
climate.zone_3_basement_bath_and_common	heat		zone 3 basement bath and common
climate.zone_4_garage	heat		Zone 4 Garage
climate.zone_5_virtual_thermostat_first_floor_living	heat		zone 5 virtual thermostat - first floor living
climate.zone_6_master_thermostat	heat		zone 6 master thermostat
climate.zone_7_basement_bar_and_tv_room_south_side	heat		zone 7 basement bar and tv room south side
climate.zone_8_dining_room	heat		zone 8 Dining room
climate.zone_9_basement_bedroom	heat		zone 9 basement bedroom
counter.hc_coincident_z1_z2_total	0		HC Coincident Z1+Z2 Total
counter.hc_coincident_z1_z3_total	0		HC Coincident Z1+Z3 Total
counter.hc_coincident_z1_z4_total	0		HC Coincident Z1+Z4 Total
counter.hc_coincident_z1_z5_total	0		HC Coincident Z1+Z5 Total
counter.hc_coincident_z1_z6_total	0		HC Coincident Z1+Z6 Total
counter.hc_coincident_z1_z7_total	0		HC Coincident Z1+Z7 Total
counter.hc_coincident_z1_z8_total	1		HC Coincident Z1+Z8 Total
counter.hc_coincident_z1_z9_total	1		HC Coincident Z1+Z9 Total
counter.hc_coincident_z2_z3_total	0		HC Coincident Z2+Z3 Total
counter.hc_coincident_z2_z4_total	0		HC Coincident Z2+Z4 Total
counter.hc_coincident_z2_z5_total	0		HC Coincident Z2+Z5 Total
counter.hc_coincident_z2_z6_total	0		HC Coincident Z2+Z6 Total
counter.hc_coincident_z2_z7_total	0		HC Coincident Z2+Z7 Total
counter.hc_coincident_z2_z8_total	0		HC Coincident Z2+Z8 Total
counter.hc_coincident_z2_z9_total	0		HC Coincident Z2+Z9 Total
counter.hc_coincident_z3_z4_total	0		HC Coincident Z3+Z4 Total
counter.hc_coincident_z3_z5_total	0		HC Coincident Z3+Z5 Total
counter.hc_coincident_z3_z6_total	0		HC Coincident Z3+Z6 Total
counter.hc_coincident_z3_z7_total	0		HC Coincident Z3+Z7 Total
counter.hc_coincident_z3_z8_total	0		HC Coincident Z3+Z8 Total
counter.hc_coincident_z3_z9_total	0		HC Coincident Z3+Z9 Total
counter.hc_coincident_z4_z5_total	0		HC Coincident Z4+Z5 Total
counter.hc_coincident_z4_z6_total	0		HC Coincident Z4+Z6 Total
counter.hc_coincident_z4_z7_total	0		HC Coincident Z4+Z7 Total
counter.hc_coincident_z4_z8_total	0		HC Coincident Z4+Z8 Total
counter.hc_coincident_z4_z9_total	0		HC Coincident Z4+Z9 Total
counter.hc_coincident_z5_z6_total	0		HC Coincident Z5+Z6 Total
counter.hc_coincident_z5_z7_total	0		HC Coincident Z5+Z7 Total
counter.hc_coincident_z5_z8_total	0		HC Coincident Z5+Z8 Total
counter.hc_coincident_z5_z9_total	0		HC Coincident Z5+Z9 Total
counter.hc_coincident_z6_z7_total	0		HC Coincident Z6+Z7 Total
counter.hc_coincident_z6_z8_total	0		HC Coincident Z6+Z8 Total
counter.hc_coincident_z6_z9_total	0		HC Coincident Z6+Z9 Total
counter.hc_coincident_z7_z8_total	0		HC Coincident Z7+Z8 Total
counter.hc_coincident_z7_z9_total	0		HC Coincident Z7+Z9 Total
counter.hc_coincident_z8_z9_total	1		HC Coincident Z8+Z9 Total
counter.hc_dispatch_calls_z1_today	1		HC Z1 Call Starts Today
counter.hc_dispatch_calls_z2_today	1		HC Z2 Call Starts Today
counter.hc_dispatch_calls_z3_today	0		HC Z3 Call Starts Today
counter.hc_dispatch_calls_z4_today	1		HC Z4 Call Starts Today
counter.hc_dispatch_calls_z5_today	1		HC Z5 Call Starts Today
counter.hc_dispatch_calls_z6_today	0		HC Z6 Call Starts Today
counter.hc_dispatch_calls_z7_today	1		HC Z7 Call Starts Today
counter.hc_dispatch_calls_z8_today	3		HC Z8 Call Starts Today
counter.hc_dispatch_calls_z9_today	6		HC Z9 Call Starts Today
counter.hc_dispatch_pair_z1_z5	0		HC Pair Z1↔Z5 Within Window
counter.hc_dispatch_pair_z1_z8	1		HC Pair Z1↔Z8 Within Window
counter.hc_dispatch_pair_z2_z6	0		HC Pair Z2↔Z6 Within Window
counter.hc_dispatch_pair_z3_z7	0		HC Pair Z3↔Z7 Within Window
counter.hc_dispatch_pair_z3_z9	0		HC Pair Z3↔Z9 Within Window
counter.hc_dispatch_pair_z5_z8	0		HC Pair Z5↔Z8 Within Window
counter.hc_dispatch_pair_z7_z9	0		HC Pair Z7↔Z9 Within Window
input_boolean.hc_disp_z1_follow_broadcast	off		HC DISP Z1 Follow Broadcast (First Floor Bedroom & Bath)
input_boolean.hc_disp_z2_follow_broadcast	off		HC DISP Z2 Follow Broadcast (Office & Upper Guest)
input_boolean.hc_disp_z3_follow_broadcast	on		HC DISP Z3 Follow Broadcast (Basement Bath & Common)
input_boolean.hc_disp_z4_follow_broadcast	off		HC DISP Z4 Follow Broadcast (Garage)
input_boolean.hc_disp_z5_follow_broadcast	off		HC DISP Z5 Follow Broadcast (First Floor Living)
input_boolean.hc_disp_z6_follow_broadcast	off		HC DISP Z6 Follow Broadcast (Master)
input_boolean.hc_disp_z7_follow_broadcast	on		HC DISP Z7 Follow Broadcast (Basement Bar & TV South)
input_boolean.hc_disp_z8_follow_broadcast	off		HC DISP Z8 Follow Broadcast (Dining Room)
input_boolean.hc_disp_z9_follow_broadcast	on		HC DISP Z9 Follow Broadcast (Basement Bedroom)
input_boolean.hc_dispatcher_advisory_enabled	on		HC Dispatcher Advisory Enabled
input_boolean.hc_dispatcher_mode_enabled	off		HC Dispatcher Mode Enabled (Stage 3)
input_boolean.hc_enable_setpoint_broadcast	on		HC Enable Setpoint Broadcast
input_datetime.hc_coincident_last_on_z1	2026-01-17 20:06:33		HC Coincident Last On Z1
input_datetime.hc_coincident_last_on_z2	2026-01-17 00:43:38		HC Coincident Last On Z2
input_datetime.hc_coincident_last_on_z3	2026-01-16 00:00:00		HC Coincident Last On Z3
input_datetime.hc_coincident_last_on_z4	2026-01-17 02:33:35		HC Coincident Last On Z4
input_datetime.hc_coincident_last_on_z5	2026-01-17 01:57:47		HC Coincident Last On Z5
input_datetime.hc_coincident_last_on_z6	2026-01-16 00:00:00		HC Coincident Last On Z6
input_datetime.hc_coincident_last_on_z7	2026-01-17 12:42:13		HC Coincident Last On Z7
input_datetime.hc_coincident_last_on_z8	2026-01-17 20:06:33		HC Coincident Last On Z8
input_datetime.hc_coincident_last_on_z9	2026-01-17 20:06:33		HC Coincident Last On Z9
input_datetime.hc_dispatch_last_on_z1	2026-01-17 20:06:13		HC Dispatch Last ON Z1
input_datetime.hc_dispatch_last_on_z2	2026-01-17 00:43:18		HC Dispatch Last ON Z2
input_datetime.hc_dispatch_last_on_z3	2026-01-16 10:46:39		HC Dispatch Last ON Z3
input_datetime.hc_dispatch_last_on_z4	2026-01-17 02:33:15		HC Dispatch Last ON Z4
input_datetime.hc_dispatch_last_on_z5	2026-01-17 01:57:27		HC Dispatch Last ON Z5
input_datetime.hc_dispatch_last_on_z6	2026-01-12 00:00:00		HC Dispatch Last ON Z6
input_datetime.hc_dispatch_last_on_z7	2026-01-17 12:41:53		HC Dispatch Last ON Z7
input_datetime.hc_dispatch_last_on_z8	2026-01-17 20:06:13		HC Dispatch Last ON Z8
input_datetime.hc_dispatch_last_on_z9	2026-01-17 20:06:13		HC Dispatch Last ON Z9
input_number.hc_boiler_return_temp_proxy_f	170.0		HC Boiler Return Temp Proxy (°F)
input_number.hc_boiler_supply_temp_proxy_f	190.0		HC Boiler Supply Temp Proxy (°F)
input_number.hc_coincident_window_min	10.0	min	HC Coincident Window (min)
input_number.hc_dispatch_batch_window_sec	180.0	s	HC Dispatch Batch Window
input_number.hc_dispatch_near_call_margin_f	0.3	°F	HC Dispatch Near-Call Margin
input_select.hc_dispatch_profile	Basement (Z3+Z7+Z9)		HC Dispatch Profile
script.hc_broadcast_basement_setpoint	off		HC Broadcast Basement Setpoint
script.hc_broadcast_first_floor_setpoint	off		HC Broadcast First Floor Setpoint
script.hc_broadcast_garage_setpoint	off		HC Broadcast Garage Setpoint
script.hc_broadcast_master_setpoint	off		HC Broadcast Master Setpoint
script.hc_broadcast_upper_floor_setpoint	off		HC Broadcast Upper Floor Setpoint
script.hc_coincident_reset_counters	off		HC Coincident Reset Counters
script.hc_kick_hydronic_after_broadcast	off		HC Kick Hydronic After Broadcast
sensor.boiler_room_water_sensor_battery	100	%	Boiler Room Water Sensor Battery
sensor.hc_basement_call_for_heat_hours_today	14.14	h	HC Basement Call For Heat - Hours Today
sensor.hc_boiler_return_temp	170.0	°F	HC Boiler Return Temp
sensor.hc_boiler_supply_temp	190.0	°F	HC Boiler Supply Temp
sensor.hc_coincident_matrix	10m		HC Coincident Matrix
sensor.hc_coincident_top_pairs	z1-z8: 1		HC Coincident Top Pairs
sensor.hc_dispatch_active_zones	none		HC Dispatch Active Zones
sensor.hc_dispatch_near_call_zones	none		HC Dispatch Near-Call Zones
sensor.hc_dispatch_suggested_batch	idle		HC Dispatch Suggested Batch
sensor.hc_first_floor_call_for_heat_hours_today	2.57	h	HC First Floor Call For Heat - Hours Today
sensor.hc_garage_call_for_heat_hours_today	7.53	h	HC Garage Call For Heat - Hours Today
sensor.hc_indoor_outdoor_delta	39.2	°F	HC Indoor–Outdoor Delta
sensor.hc_upper_floor_call_for_heat_hours_today	3.73	h	HC Upper Floor Call For Heat - Hours Today
sensor.hc_whole_house_call_for_heat_hours_today	15.44	h	HC Whole House Call For Heat - Hours Today
sensor.hc_z1_delta	2.0	°F	HC Z1 Delta
sensor.hc_z1_first_floor_bedroom_bath_call_for_heat_hours_today	0.05	h	HC Z1 – First Floor Bedroom & Bath – Call For Heat – Hours Today
sensor.hc_z2_delta	0.0	°F	HC Z2 Delta
sensor.hc_z2_office_upper_guest_call_for_heat_hours_today	3.73	h	HC Z2 – Office & Upper Guest – Call For Heat – Hours Today
sensor.hc_z3_basement_bath_common_call_for_heat_hours_today	0.0	h	HC Z3 – Basement Bath & Common – Call For Heat – Hours Today
sensor.hc_z3_delta	0.0	°F	HC Z3 Delta
sensor.hc_z4_delta	-3.0	°F	HC Z4 Delta
sensor.hc_z4_garage_call_for_heat_hours_today	7.53	h	HC Z4 – Garage – Call For Heat – Hours Today
sensor.hc_z5_delta	-1.0	°F	HC Z5 Delta
sensor.hc_z5_first_floor_living_call_for_heat_hours_today	1.2	h	HC Z5 – First Floor Living – Call For Heat – Hours Today
sensor.hc_z6_delta	-8.0	°F	HC Z6 Delta
sensor.hc_z6_master_call_for_heat_hours_today	0.0	h	HC Z6 – Master – Call For Heat – Hours Today
sensor.hc_z7_basement_bar_tv_south_call_for_heat_hours_today	10.37	h	HC Z7 – Basement Bar & TV South – Call For Heat – Hours Today
sensor.hc_z7_delta	2.0	°F	HC Z7 Delta
sensor.hc_z8_delta	1.0	°F	HC Z8 Delta
sensor.hc_z8_dining_room_call_for_heat_hours_today	2.37	h	HC Z8 – Dining Room – Call For Heat – Hours Today
sensor.hc_z9_basement_bedroom_call_for_heat_hours_today	9.45	h	HC Z9 – Basement Bedroom – Call For Heat – Hours Today
sensor.hc_z9_delta	4.0	°F	HC Z9 Delta
switch.z1	on		Z1 - north first floor bedroom and bath and entry
switch.z2	off		Z2 - Second floor office and upper guest
switch.z3	off		Z3 - Basement bath utility common area
switch.z4	off		Z4 - garage
switch.z5	off		Z5 - first floor living
switch.z6	off		Z6 -master
switch.z7	off		Z7 - basement kitchen and tv area
switch.z8	on		Z8 - dining mad man
switch.z9	on		Z9 - basement bedroom
