automation.basement_heat_on_and_off	automation	None	1764739945517
automation.hc_auto_broadcast_basement_setpoint	automation	None	hc_auto_broadcast_basement_setpoint
automation.hc_auto_broadcast_first_floor_setpoint	automation	None	hc_auto_broadcast_first_floor_setpoint
automation.hc_auto_broadcast_garage_setpoint	automation	None	hc_auto_broadcast_garage_setpoint
automation.hc_auto_broadcast_master_setpoint_overrides_floors	automation	None	hc_auto_broadcast_master_setpoint
automation.hc_auto_broadcast_upper_floor_setpoint	automation	None	hc_auto_broadcast_upper_floor_setpoint
automation.hc_cold_tolerance_gate_block_zone_turn_on	automation	None	hc_cold_tolerance_gate_block_on
automation.hc_dispatcher_advisory_reset_counters_daily	automation	None	hc_dispatch_advisory_reset_counters_daily
automation.hc_dispatcher_advisory_track_call_starts	automation	None	hc_dispatch_advisory_track_call_starts
automation.master_heat_off	automation	None	1764737341675
automation.master_heat_on	automation	None	1764736926515
automation.reboot_hubitat_integration	automation	None	1762466176853
counter.hc_dispatch_calls_z1_today	counter	None	hc_dispatch_calls_z1_today
counter.hc_dispatch_calls_z2_today	counter	None	hc_dispatch_calls_z2_today
counter.hc_dispatch_calls_z3_today	counter	None	hc_dispatch_calls_z3_today
counter.hc_dispatch_calls_z4_today	counter	None	hc_dispatch_calls_z4_today
counter.hc_dispatch_calls_z5_today	counter	None	hc_dispatch_calls_z5_today
counter.hc_dispatch_calls_z6_today	counter	None	hc_dispatch_calls_z6_today
counter.hc_dispatch_calls_z7_today	counter	None	hc_dispatch_calls_z7_today
counter.hc_dispatch_calls_z8_today	counter	None	hc_dispatch_calls_z8_today
counter.hc_dispatch_calls_z9_today	counter	None	hc_dispatch_calls_z9_today
counter.hc_dispatch_pair_z1_z5	counter	None	hc_dispatch_pair_z1_z5
counter.hc_dispatch_pair_z1_z8	counter	None	hc_dispatch_pair_z1_z8
counter.hc_dispatch_pair_z2_z6	counter	None	hc_dispatch_pair_z2_z6
counter.hc_dispatch_pair_z3_z7	counter	None	hc_dispatch_pair_z3_z7
counter.hc_dispatch_pair_z3_z9	counter	None	hc_dispatch_pair_z3_z9
counter.hc_dispatch_pair_z5_z8	counter	None	hc_dispatch_pair_z5_z8
counter.hc_dispatch_pair_z7_z9	counter	None	hc_dispatch_pair_z7_z9
input_boolean.hc_dispatcher_advisory_enabled	input_boolean	None	hc_dispatcher_advisory_enabled
input_boolean.hc_enable_cold_tolerance_gate	input_boolean	None	hc_enable_cold_tolerance_gate
input_boolean.hc_enable_minisplit_auto_on_setpoint	input_boolean	None	hc_enable_minisplit_auto_on_setpoint
input_boolean.hc_enable_setpoint_broadcast	input_boolean	None	hc_enable_setpoint_broadcast
input_boolean.high_country_sanity_flag	input_boolean	None	high_country_sanity_flag
input_datetime.hc_dispatch_last_on_z1	input_datetime	None	hc_dispatch_last_on_z1
input_datetime.hc_dispatch_last_on_z2	input_datetime	None	hc_dispatch_last_on_z2
input_datetime.hc_dispatch_last_on_z3	input_datetime	None	hc_dispatch_last_on_z3
input_datetime.hc_dispatch_last_on_z4	input_datetime	None	hc_dispatch_last_on_z4
input_datetime.hc_dispatch_last_on_z5	input_datetime	None	hc_dispatch_last_on_z5
input_datetime.hc_dispatch_last_on_z6	input_datetime	None	hc_dispatch_last_on_z6
input_datetime.hc_dispatch_last_on_z7	input_datetime	None	hc_dispatch_last_on_z7
input_datetime.hc_dispatch_last_on_z8	input_datetime	None	hc_dispatch_last_on_z8
input_datetime.hc_dispatch_last_on_z9	input_datetime	None	hc_dispatch_last_on_z9
input_number.hc_cold_tolerance	input_number	None	hc_cold_tolerance
input_number.hc_dispatch_batch_window_sec	input_number	None	hc_dispatch_batch_window_sec
input_number.hc_dispatch_near_call_margin_f	input_number	None	hc_dispatch_near_call_margin_f
input_number.hc_setpoint_basement	input_number	None	hc_setpoint_basement
input_number.hc_setpoint_first_floor	input_number	None	hc_setpoint_first_floor
input_number.hc_setpoint_garage	input_number	None	hc_setpoint_garage
input_number.hc_setpoint_master	input_number	None	hc_setpoint_master
input_number.hc_setpoint_upper_floor	input_number	None	hc_setpoint_upper_floor
input_select.hc_dispatch_profile	input_select	None	hc_dispatch_profile
input_select.hc_minisplit_preferred_mode	input_select	None	hc_minisplit_preferred_mode
script.hc_apply_cold_tolerance_and_restart	script	None	hc_apply_cold_tolerance_and_restart
script.hc_broadcast_basement_setpoint	script	None	hc_broadcast_basement_setpoint
script.hc_broadcast_first_floor_setpoint	script	None	hc_broadcast_first_floor_setpoint
script.hc_broadcast_garage_setpoint	script	None	hc_broadcast_garage_setpoint
script.hc_broadcast_master_setpoint	script	None	hc_broadcast_master_setpoint
script.hc_broadcast_upper_floor_setpoint	script	None	hc_broadcast_upper_floor_setpoint
script.hc_kick_hydronic_after_broadcast	script	None	hc_kick_hydronic_after_broadcast
script.hc_kick_hydronic_thermostats	script	None	hc_kick_hydronic_thermostats
script.hc_minisplits_apply_mode	script	None	hc_minisplits_apply_mode
script.hc_retry_mismatched_minisplits	script	None	hc_retry_mismatched_minisplits
